╔══════════════════════════════╗
║                              ║
║                              ║
║                              ║
║                              ║
║                              ║
║                              ║
║                              ║
║                              ║
║                              ║
║                              ║
║                              ║
║                              ║
║                              ║
║                              ║
║                              ║
║                              ║
║                              ║
║                              ║
║                              ║
║                              ║
╚══════════════════════════════╝